"co" = (/obj/structure/window/reinforced/survival_pod{dir = 8},/obj/structure/window/reinforced/survival_pod{dir = 4},/obj/structure/window/reinforced/survival_pod{dir = 1},/obj/structure/window/reinforced/survival_pod,/obj/structure/grille,/turf/simulated/shuttle/floor/voidcraft/dark,/area/survivalpod)
"cK" = (/obj/item/device/gps/computer{density = 0; pixel_y = 0},/obj/structure/disposalpipe/segment{dir = 4},/turf/simulated/floor/carpet/sblucarpet,/area/survivalpod)
"cV" = (/obj/structure/closet/hydrant{pixel_y = 32},/turf/simulated/floor/carpet/sblucarpet,/area/survivalpod)
"dB" = (/obj/structure/window/reinforced/survival_pod{dir = 8},/obj/structure/bed/chair/comfy/blue{dir = 4},/turf/simulated/floor/carpet/bcarpet,/area/survivalpod)
"ei" = (/obj/structure/bed/chair/sofa/beige,/turf/simulated/floor/carpet/sblucarpet,/area/survivalpod)
"et" = (/obj/structure/disposalpipe/segment{dir = 1; icon_state = "pipe-c"},/turf/simulated/floor/carpet/sblucarpet,/area/survivalpod)
"eL" = (/obj/machinery/disposal,/obj/structure/disposalpipe/trunk{dir = 8},/turf/simulated/floor/carpet/bcarpet,/area/survivalpod)
"fE" = (/obj/structure/table/alien,/obj/machinery/floor_light/prebuilt,/turf/simulated/shuttle/floor/voidcraft/dark,/area/survivalpod)
"fW" = (/obj/structure/sign/mining/survival,/turf/simulated/shuttle/wall/voidcraft/survival/hard_corner,/area/survivalpod)
"gO" = (/obj/structure/closet/secure_closet/freezer/fridge,/turf/simulated/shuttle/floor/voidcraft/dark,/area/survivalpod)
"ig" = (/obj/structure/sink/kitchen{dir = 8; pixel_x = 11},/turf/simulated/shuttle/floor/voidcraft/dark,/area/survivalpod)
"ik" = (/obj/structure/bed/chair/sofa/beige/corner{dir = 1},/turf/simulated/floor/carpet/sblucarpet,/area/survivalpod)
"iR" = (/obj/structure/window/reinforced/survival_pod{dir = 4},/obj/structure/closet/secure_closet/personal,/obj/item/weapon/towel/random,/turf/simulated/floor/carpet/bcarpet,/area/survivalpod)
"ka" = (/obj/machinery/light,/obj/structure/disposalpipe/segment{dir = 1; icon_state = "pipe-c"},/obj/structure/table/alien,/obj/machinery/chemical_dispenser/bar_soft/full{dir = 1},/turf/simulated/shuttle/floor/voidcraft/dark,/area/survivalpod)
"kb" = (/obj/structure/sign/mining/survival{dir = 8},/turf/simulated/shuttle/wall/voidcraft/survival,/area/survivalpod)
"kw" = (/obj/structure/window/reinforced/survival_pod{dir = 8},/obj/structure/closet/secure_closet/personal,/obj/item/weapon/towel/random,/turf/simulated/floor/carpet/bcarpet,/area/survivalpod)
"lr" = (/obj/structure/table/alien,/obj/item/weapon/reagent_containers/food/drinks/cup{pixel_x = -10; pixel_y = 8},/obj/item/weapon/reagent_containers/food/drinks/cup{pixel_x = -10; pixel_y = 4},/obj/item/weapon/reagent_containers/food/drinks/cup{pixel_x = -10},/obj/item/weapon/reagent_containers/food/drinks/cup{pixel_x = -10; pixel_y = -4},/obj/item/weapon/reagent_containers/food/drinks/glass2/square{pixel_x = 3; pixel_y = 5},/turf/simulated/shuttle/floor/voidcraft/dark,/area/survivalpod)
"lN" = (/obj/machinery/door/airlock/voidcraft/survival_pod,/obj/structure/fans/tiny,/obj/effect/floor_decal/industrial/danger/full,/obj/machinery/door/blast/regular{density = 0; dir = 4; icon_state = "pdoor0"; id = "shelterblast"; name = "Shelter Blast Doors"; opacity = 0},/turf/simulated/shuttle/floor/voidcraft/dark,/area/survivalpod)
"md" = (/obj/structure/disposalpipe/segment{dir = 4},/obj/structure/table/alien,/obj/machinery/chemical_dispenser/bar_coffee/full{dir = 1},/turf/simulated/shuttle/floor/voidcraft/dark,/area/survivalpod)
"my" = (/obj/machinery/recharge_station,/turf/simulated/floor/carpet/sblucarpet,/area/survivalpod)
"mE" = (/obj/structure/table/alien,/obj/machinery/floor_light/prebuilt,/obj/item/weapon/reagent_containers/food/condiment/small/sugar{pixel_x = -11; pixel_y = 1},/turf/simulated/shuttle/floor/voidcraft/dark,/area/survivalpod)
"mR" = (/obj/machinery/disposal,/obj/structure/disposalpipe/trunk{dir = 4},/turf/simulated/floor/carpet/bcarpet,/area/survivalpod)
"mX" = (/obj/structure/sign/mining/survival{dir = 8},/turf/simulated/shuttle/wall/voidcraft/survival/hard_corner,/area/survivalpod)
"np" = (/obj/machinery/door/airlock/voidcraft/survival_pod,/obj/effect/floor_decal/industrial/hatch,/obj/structure/disposalpipe/segment,/turf/simulated/shuttle/floor/voidcraft,/area/survivalpod)
"oL" = (/obj/machinery/appliance/cooker/oven,/turf/simulated/shuttle/floor/voidcraft/dark,/area/survivalpod)
"oT" = (/obj/structure/bed/chair/sofa/beige/right{dir = 4},/turf/simulated/floor/carpet/sblucarpet,/area/survivalpod)
"pH" = (/obj/structure/sign/mining/survival{dir = 1},/turf/simulated/shuttle/wall/voidcraft/survival,/area/survivalpod)
"rD" = (/obj/structure/disposalpipe/segment,/turf/simulated/floor/carpet/sblucarpet,/area/survivalpod)
"vg" = (/obj/machinery/door/window/survival_pod,/turf/simulated/floor/carpet/bcarpet,/area/survivalpod)
"vG" = (/obj/structure/sign/mining/survival{dir = 4},/turf/simulated/shuttle/wall/voidcraft/survival/hard_corner,/area/survivalpod)
"xj" = (/obj/structure/toilet{dir = 4},/obj/machinery/light,/turf/simulated/shuttle/floor/voidcraft/dark,/area/survivalpod)
"yU" = (/obj/structure/sign/mining/survival{dir = 1},/turf/simulated/shuttle/wall/voidcraft/survival/hard_corner,/area/survivalpod)
"zH" = (/obj/structure/sink{dir = 8; pixel_x = -12; pixel_y = 5},/turf/simulated/shuttle/floor/voidcraft/dark,/area/survivalpod)
"CF" = (/obj/structure/bed/pod,/obj/item/weapon/bedsheet/ce,/turf/simulated/floor/carpet/bcarpet,/area/survivalpod)
"DF" = (/obj/structure/bed/double/padded,/obj/item/weapon/bedsheet/hopdouble,/turf/simulated/floor/carpet/bcarpet,/area/survivalpod)
"EG" = (/obj/structure/disposalpipe/junction,/turf/simulated/floor/carpet/sblucarpet,/area/survivalpod)
"EL" = (/obj/structure/table/alien,/obj/machinery/floor_light/prebuilt,/obj/item/weapon/reagent_containers/food/condiment/small/saltshaker{pixel_x = 7; pixel_y = 7},/obj/item/weapon/reagent_containers/food/condiment/small/peppermill{pixel_x = 13; pixel_y = 7},/turf/simulated/shuttle/floor/voidcraft/dark,/area/survivalpod)
"FS" = (/obj/structure/bed/pod,/obj/item/weapon/bedsheet/hos,/turf/simulated/floor/carpet/bcarpet,/area/survivalpod)
"Gn" = (/obj/machinery/light{dir = 1},/obj/structure/disposalpipe/segment{dir = 4},/turf/simulated/floor/carpet/sblucarpet,/area/survivalpod)
"GP" = (/obj/structure/fans{density = 0; pixel_y = 32},/obj/structure/disposalpipe/segment{dir = 4},/turf/simulated/floor/carpet/sblucarpet,/area/survivalpod)
"Hl" = (/obj/structure/table/steel,/obj/item/weapon/material/kitchen/rollingpin{pixel_x = -3; pixel_y = 2},/obj/item/weapon/material/knife/butch,/obj/item/weapon/reagent_containers/dropper{pixel_x = -6; pixel_y = 8},/obj/structure/window/reinforced/survival_pod{dir = 4},/turf/simulated/shuttle/floor/voidcraft/dark,/area/survivalpod)
"Hm" = (/obj/item/weapon/stool/padded,/turf/simulated/floor/carpet/sblucarpet,/area/survivalpod)
"Ie" = (/obj/machinery/door/window/survival_pod{dir = 8},/turf/simulated/floor/carpet/bcarpet,/area/survivalpod)
"Jm" = (/obj/structure/sign/mining/survival{dir = 4},/obj/structure/disposalpipe/segment{dir = 4},/turf/simulated/shuttle/wall/voidcraft/survival,/area/survivalpod)
"Jn" = (/turf/simulated/floor/carpet/bcarpet,/area/survivalpod)
"KM" = (/turf/simulated/shuttle/wall/voidcraft/survival/hard_corner,/area/survivalpod)
"KQ" = (/obj/machinery/shower,/obj/item/weapon/soap/deluxe,/obj/structure/curtain,/turf/simulated/shuttle/floor/voidcraft/dark,/area/survivalpod)
"KS" = (/obj/structure/disposalpipe/segment{dir = 2; icon_state = "pipe-c"},/turf/simulated/floor/carpet/bcarpet,/area/survivalpod)
"LL" = (/obj/machinery/door/window/survival_pod,/turf/simulated/shuttle/floor/voidcraft/dark,/area/survivalpod)
"NA" = (/obj/structure/table/alien,/obj/machinery/floor_light/prebuilt,/obj/machinery/microwave,/turf/simulated/shuttle/floor/voidcraft/dark,/area/survivalpod)
"NC" = (/obj/machinery/vending/dinnerware{dir = 1},/turf/simulated/floor/carpet/sblucarpet,/area/survivalpod)
"NL" = (/obj/machinery/smartfridge/survival_pod{density = 0; pixel_y = 32},/obj/item/weapon/storage/firstaid/adv,/obj/item/weapon/storage/firstaid/adv,/obj/item/weapon/storage/firstaid/adv,/obj/item/weapon/storage/mre/menu10,/obj/item/weapon/storage/mre/menu10,/obj/item/weapon/storage/mre/menu10,/obj/item/weapon/storage/mre/menu10,/obj/item/weapon/storage/mre/menu11,/obj/item/weapon/storage/mre/menu11,/obj/item/weapon/storage/mre/menu11,/obj/item/weapon/storage/mre/menu11,/obj/item/weapon/storage/box/survival/space,/obj/item/weapon/storage/box/survival/space,/obj/item/weapon/storage/box/survival/space,/obj/item/weapon/storage/box/survival/space,/obj/item/weapon/storage/box/survival/comp,/obj/item/weapon/storage/box/survival/comp,/obj/item/device/binoculars,/obj/item/weapon/storage/pill_bottle/nutriment,/obj/item/weapon/storage/pill_bottle/iron,/obj/item/weapon/storage/pill_bottle/arithrazine,/obj/item/weapon/reagent_containers/blood/OMinus,/obj/item/weapon/reagent_containers/blood/OMinus,/obj/item/weapon/reagent_containers/blood/OMinus,/obj/item/device/fbp_backup_cell,/obj/item/device/fbp_backup_cell,/obj/item/device/fbp_backup_cell,/obj/item/device/fbp_backup_cell,/obj/item/device/fbp_backup_cell,/obj/item/weapon/storage/pill_bottle/nutriment,/obj/item/weapon/storage/pill_bottle/iron,/obj/item/weapon/storage/pill_bottle/arithrazine,/obj/item/weapon/storage/pill_bottle/corophizine,/obj/item/weapon/towel/random,/obj/item/weapon/towel/random,/obj/item/weapon/extinguisher/mini,/obj/item/weapon/reagent_containers/food/drinks/drinkingglass/fitnessflask/glucose,/obj/structure/disposalpipe/segment{dir = 4},/obj/item/weapon/storage/box/donkpockets{pixel_x = 3; pixel_y = 3},/obj/item/weapon/storage/box/donkpockets{pixel_x = 3; pixel_y = 3},/turf/simulated/floor/carpet/sblucarpet,/area/survivalpod)
"Ok" = (/turf/simulated/shuttle/floor/voidcraft/dark,/area/survivalpod)
"OJ" = (/obj/structure/sink/kitchen{dir = 4; pixel_x = -11},/turf/simulated/shuttle/floor/voidcraft/dark,/area/survivalpod)
"Qk" = (/obj/structure/bed/chair/sofa/beige/left,/obj/structure/disposalpipe/segment{dir = 4},/obj/structure/disposalpipe/segment,/turf/simulated/floor/carpet/sblucarpet,/area/survivalpod)
"QA" = (/obj/structure/fans/tiny,/obj/machinery/door/airlock/voidcraft/vertical,/obj/effect/floor_decal/industrial/danger/full,/obj/machinery/door/blast/regular{density = 0; icon_state = "pdoor0"; id = "shelterblast"; name = "Shelter Blast Doors"; opacity = 0},/turf/simulated/shuttle/floor/voidcraft/dark,/area/survivalpod)
"RA" = (/obj/machinery/light,/obj/structure/table/steel,/obj/machinery/reagentgrinder{pixel_x = -7; pixel_y = 5},/obj/item/weapon/reagent_containers/food/condiment/enzyme{layer = 5; pixel_x = 13; pixel_y = 4},/turf/simulated/shuttle/floor/voidcraft/dark,/area/survivalpod)
"TQ" = (/obj/structure/toilet{dir = 8},/obj/machinery/light,/turf/simulated/shuttle/floor/voidcraft/dark,/area/survivalpod)
"Ug" = (/obj/structure/disposalpipe/junction{dir = 2; icon_state = "pipe-j2"},/turf/simulated/floor/carpet/sblucarpet,/area/survivalpod)
"Ur" = (/obj/machinery/disposal,/obj/structure/disposalpipe/trunk{dir = 8},/turf/simulated/floor/carpet/sblucarpet,/area/survivalpod)
"UI" = (/turf/simulated/shuttle/wall/voidcraft/survival,/area/survivalpod)
"Va" = (/obj/machinery/light{dir = 1},/turf/simulated/floor/carpet/bcarpet,/area/survivalpod)
"WG" = (/obj/structure/sign/mining/survival{dir = 4},/turf/simulated/shuttle/wall/voidcraft/survival,/area/survivalpod)
"Xs" = (/obj/structure/window/reinforced/survival_pod{dir = 4},/obj/structure/bed/chair/comfy/blue{dir = 8},/turf/simulated/floor/carpet/bcarpet,/area/survivalpod)
"XF" = (/obj/structure/disposalpipe/segment{dir = 4; icon_state = "pipe-c"},/turf/simulated/floor/carpet/bcarpet,/area/survivalpod)
"XU" = (/turf/simulated/floor/carpet/sblucarpet,/area/survivalpod)
"Yd" = (/obj/structure/sign/mining/survival,/turf/simulated/shuttle/wall/voidcraft/survival,/area/survivalpod)

(1,1,1) = {"
UIpHKMyUKMyUKMyUKMpHUI
kbFSVaXsKQKMKQdBVaDFWG
KMCFJnvgigKMOJIeJnJnKM
mXmRKSiRTQKMxjkwXFeLvG
KMKMnpKMKMKMKMKMnpKMKM
QAcVetGnGPNLcKGnEGXUQA
coXUHmHmHmXUXUXUUgUrco
mXNAELmEfEXUikeiQkmyvG
cozHOkOkLLXUoTXUrDXUco
kboLgORAHlXUNClrkamdJm
UIYdKMfWKMlNKMfWcoYdUI
"}
